— PERFORMERS —	— PERFORMERS —
PICCOLO	PICCOLO	Cheryl Carr	Dan Gonda	Riley Zielinski
FLUTE	FLUTE	Claudia Lindner (1)	Henry Zhang (1, 2)	Jennette Yee (1)	Katherine Rosen (1)	Lucia C. (1, 2)	Riley Zielinski (1, 2)	Cheryl Carr (2)
BASS RECORDER	BASS RECORDER	Nicholas DeGraba
OBOE	OBOE	Eddie Chung
ENGLISH HORN	ENGLISH HORN	Eddie Chung
E♭ CLARINET	E_ CLARINET	Andrew Robinson	Dan Kolb
B♭ CLARINET	B_ CLARINET	Chris Erickson (1, 2)	zmand97 (1)	Daniel Scates (2)
BASS CLARINET	BASS CLARINET	Dan Gonda	Marcus Stables
CONTRABASS CLARINET	CONTRABASS CLARINET	Marcus Stables
BASSOON	BASSOON	Andrew S
CONTRABASSOON	CONTRABASSOON	Andrew S
SOPRANO SAXOPHONE	SOPRANO SAXOPHONE	Jonathan Shi
ALTO SAXOPHONE	ALTO SAXOPHONE	Andrew S (1, 2)	Ciara Donegan (1, 2)	Dan Eckels (1, 2)	Finlay Mckechnie (1)	Jonathan Shi (1, 2)	TK (1, 2)
TENOR SAXOPHONE	TENOR SAXOPHONE	Dan Gonda (1, 2)	Gareth Kibble (1, 2)
BARI SAX	BARI SAX	Finlay Mckechnie	Jennette Yee
HORN IN F	HORN IN F	Max Dei Rossi (1, 2, 3, 4)	William Riegel-Green (1, 2, 3)
HORN IN E♭	HORN IN E_	Brandon Harnish (4)
TRUMPET	TRUMPET	Adrian Camacho (1)	Kyle Mesce (1, 2, 3)	Francesco Dalla Ricca (2, 3)
POCKET TRUMPET	POCKET TRUMPET	Brandon Harnish (3)
TROMBONE	TROMBONE	Bryan Alvarez (1, 2)	Brandon Harnish (2)	Jennette Yee (2)
ROGUE TROMBONE	ROGUE TROMBONE	Andrew S (1A, 1B, 2)	Brandon Harnish (1A, 1B, 2)	Bryan Alvarez (1A, 1B, 2)	John MacKay (1A, 1B)	Justin Miller (1A, 1B, 2)	Robert Bengel (1A, 1B, 2)
ROGUE BASS TROMBONE	ROGUE BASS TROMBONE	John MacKay (2)
BARITONE HORN	BARITONE HORN	Brandon Harnish (1)
EUPHONIUM	EUPHONIUM	Thomas Håkanson
TUBA	TUBA	Travis Slaughter
TIMPANI	TIMPANI	Dan Kolb
CONCERT SNARE DRUM	CONCERT SNARE DRUM	Jacob Augelli	John Tabakian
FIELD SNARE DRUM	FIELD SNARE DRUM	John Tabakian
KIT SNARE DRUM	KIT SNARE DRUM	John Tabakian
CONCERT BASS DRUM	CONCERT BASS DRUM	Dan Kolb	Jacob Augelli
SUSPENDED CYMBAL	SUSPENDED CYMBAL	Dan Kolb	Jacob Augelli
ELECTRIC BASS	ELECTRIC BASS	Jeremy Benik	Rayanne Tuason
PIANO	PIANO	Lucia C.
KEYBOARD	KEYBOARD	Justin Miller
SOPRANO	SOPRANO	Caroline Augelli	Chris Erickson	Heidi Vandyk	Karenna Foley	Patricia Sanchez	Tifamin
ALTO	ALTO	Brandon Harnish	Caroline Augelli	Ciara Donegan	Patricia Sanchez
TENOR	TENOR	Brandon Harnish	Caroline Augelli	Ian Martyn	Jim Hitchell	Thomas Håkanson	Wheeljack
BASS	BASS	Jim Hitchell	Thomas Håkanson
VIOLIN	VIOLIN	Corey Johnson (I, II)	Gabrielle B. (I, II)	Malia Sittler (I)	Sean Harding (I, II)	Vincent Lee (I)	Ryan M (II)	Will Zen (II)
VIOLA	VIOLA	Aidan Backus (A, B)	Jennette Yee (A, B)	Ziad Asadi (A, B)
CELLO	CELLO	Austin Kyan (A, B)	Ryan Jung (A, B)	Enoch Ng (B)
DOUBLE BASS	DOUBLE BASS	Joseph Lee
